KABR|Aberdeen|SD
KENX|Albany|NY
KABX|Albuquerque|NM
KAMA|Amarillo|TX
PGUA|Andersen AFB|GU
KFFC|Atlanta|GA
KEWX|Austin/San Antonio|TX
KBBX|Beale AFB|CA
PABC|Bethel|AK
KBLX|Billings|MT
KBGM|Binghamton|NY
KBMX|Birmingham|AL
KBIS|Bismarck|ND
KCBX|Boise|ID
KBOX|Boston|MA
KDGX|Brandon/Jackson|MS
KBRO|Brownsville|TX
KBUF|Buffalo|NY
KCXX|Burlington|VT
KFDX|Cannon AFB|NM
KICX|Cedar City|UT
KCLX|Charleston|SC
KRLX|Charleston|WV
KCYS|Cheyenne|WY
KLOT|Chicago|IL
KCLE|Cleveland|OH
KCAE|Columbia|SC
KGWX|Columbus AFB|MS
KCRP|Corpus Christi|TX
KFWS|Dallas/Ft. Worth|TX
KDVN|Davenport|IA
KFTG|Denver|CO
KDMX|Des Moines|IA
KDTX|Detroit/Pontiac|MI
KDDC|Dodge City|KS
KDOX|Dover AFB|DE
KDLH|Duluth|MN
KDYX|Dyess AFB|TX
KEYX|Edwards AFB|CA
KEVX|Eglin AFB|FL
KEPZ|El Paso|TX
KLRX|Elko|NV
KBHX|Eureka|CA
KVWX|Evansville|IN
PAPD|Fairbanks/Pedro Dome|AK
KFSX|Flagstaff|AZ
KHPX|Fort Campbell|KY
KGRK|Fort Hood|TX
KPOE|Fort Polk|LA
KEOX|Fort Rucker|AL
KSRX|Fort Smith|AR
KFDR|Frederick|OK
KAPX|Gaylord|MI
KGGW|Glasgow|MT
KGLD|Goodland|KS
KMVX|Grand Forks (Mayville)|ND
KUEX|Grand Island/Hastings|NE
KGJX|Grand Junction|CO
KGRR|Grand Rapids|MI
KTFX|Great Falls|MT
KGRB|Green Bay|WI
KGSP|Greer|SC
KHDX|Holloman AFB|NM
KHGX|Houston/Galveston|TX
KHTX|Huntsville|AL
KIND|Indianapolis|IN
KJKL|Jackson|KY
KJAX|Jacksonville|FL
KEAX|Kansas City|MO
PHKI|Kauai|HI
PAHG|Kenai|AK
KBYX|Key West|FL
PAKC|King Salmon|AK
KMRX|Knoxville/Tri Cities|TN
PHKM|Kohala|HI
KARX|La Crosse|WI
KLCH|Lake Charles|LA
KLGX|Langley Hill|WA
KESX|Las Vegas|NV
KDFX|Laughlin AFB|TX
KILX|Lincoln|IL
KLZK|Little Rock|AR
KCBW|Loring AFB|ME
KVTX|Los Angeles|CA
KLVX|Louisville|KY
KLBB|Lubbock|TX
KMQT|Marquette|MI
KMXX|Maxwell AFB|AL
KMAX|Medford|OR
KMLB|Melbourne|FL
KNQA|Memphis|TN
KAMX|Miami|FL
PAIH|Middleton Island|AK
KMAF|Midland/Odessa|TX
KMKX|Milwaukee|WI
KMPX|Minneapolis/St. Paul|MN
KMBX|Minot AFB|ND
KMSX|Missoula|MT
KMOB|Mobile|AL
PHMO|Molokai|HI
KTYX|Montague|NY
KVAX|Moody AFB|GA
KMHX|Morehead City|NC
KOHX|Nashville|TN
KLIX|New Orleans|LA
KOKX|New York City|NY
PAEC|Nome|AK
KAKQ|Norfolk/Richmond|VA
KLNX|North Platte|NE
KIWX|North Webster|IN
KTLX|Oklahoma City|OK
KOAX|Omaha|NE
KPAH|Paducah|KY
KPDT|Pendleton|OR
KDIX|Philadelphia|PA
KIWA|Phoenix|AZ
KPBZ|Pittsburgh|PA
KSFX|Pocatello/Idaho Falls|ID
KGYX|Portland|ME
KRTX|Portland|OR
KPUX|Pueblo|CO
KRAX|Raleigh/Durham|NC
KUDX|Rapid City|SD
KRGX|Reno|NV
KRIW|Riverton|WY
KFCX|Roanoke|VA
KJGX|Robins AFB|GA
KDAX|Sacramento|CA
KMTX|Salt Lake City|UT
KSJT|San Angelo|TX
KNKX|San Diego|CA
KMUX|San Francisco|CA
KHNX|San Joaquin Valley|CA
TJUA|San Juan|PR
KSOX|Santa Ana Mountains|CA
KATX|Seattle/Tacoma|WA
KSHV|Shreveport|LA
KFSD|Sioux Falls|SD
PACG|Sitka/Biorka Island|AK
PHWA|South Shore|HI
KOTX|Spokane|WA
KSGF|Springfield|MO
KLSX|St. Louis|MO
KCCX|State College|PA
KLWX|Sterling|VA
KTLH|Tallahassee|FL
KTBW|Tampa|FL
KTWX|Topeka|KS
KEMX|Tucson|AZ
KINX|Tulsa|OK
KVNX|Vance AFB|OK
KVBX|Vandenberg AFB|CA
KICT|Wichita|KS
KILN|Wilmington|OH
KLTX|Wilmington|NC
KYUX|Yuma|AZ